pau pau
pau pau
pau pau
aa	aa
ae	ae
ah	ah
ao	ao
aw	aw
ax	ax
ax-h	ax-h
axr	axr
ay	ay
b	b
bcl	bcl
ch	ch
d	d
dcl	dcl
dh	dh
dx	dx
eh	eh
er	er
ey	ey
f	f
g	g
gcl	gcl
hh	hh
hv	hv
ih	ih
ix	ix
iy	iy
jh	jh
k	k
kcl	kcl
l	l
m	m
n	n
ng	ng
nx	nx
ow	ow
oy	oy
p	p
pau	pau
pcl	pcl
r	r
s	s
sh	sh
t	t
tcl	tcl
th	th
uh	uh
uw	uw
ux	ux
v	v
w	w
y	y
z	z
zh	zh
